1111111111111111111111111111111111
1000111111000111111000111111000001
1000C000000C000000C000000C00000001
1000111111000111111000111111000001
1000000000000000000000000000000001
1000111000001111100000111000000001
1000C110000C00000C0000110000000001
1000111000001111100000111000000001
1000000000000000000000000000000001
1000111111000111111000111111000001
1000C000000C000000C000000C00000001
1000111111000111111000111111000001
1P000000000000000000000000000000E1
1111111111111111111111111111111111
