1111111111111111111111111111111111
1C0000000000000C00000C000000000001
1110010100100000001001000000010101
1010010011101010101001000001110011
1000P0001C00C000000000000001E00011
1111111111111111111111111111111111