1111111111111111111111111111111111
1C1000000000000C00000C000000000001
1110010100100000001001000000010101
1010010011101010101001000000010011
1000P0001C10C000000000000000E00011
1111111111111111111111111111111111